1111111111111111111111111111111111
1E00000000001C1110001C0000000000C1
101001M100101000C01001000000010111
10100100101011111110010000M0010101
1P0000000C00C0000000CC000000000001
1111111111111111111111111111111111